type octile
height 80
width 100
map
TTTTTTTTTTTTTTTTTTTTTTTTTTTTTTTTTTTTTTTTTTTTTTTTTTTTTTTTTTTTTTTTTTTTTTTTTTTTTTTTTTTTTTTTTTTTTTTTTTTT
T...................................TTTTT...................................TT.....................T
T...................................TTTT....................................TT.....................T
T...................................TTT.....................................TT.....................T
T...................................TT......................................TT.....................T
T...................................T.......................................TT.....................T
T...........................................................................TT.....................T
T...........................................................................TT.....................T
T...................................T.......................................TT.......TTTTTTTTTTTTTTT
T...................................TT......................................TT.......TTTTTTTTTTTTTTT
T...................................TTT.....................................TT.......TTT...........T
T...................................TTTT....................................TT.......TTT...........T
T...................................TTTTT...................................TT.......TTT...........T
T...................................TTTTTTTTTTTTTTTTTTTTTTTTTTTTTTTTTTTT.............TTT...........T
T....................................................................................TTT...........T
TTTTTT....TTTTTTT....................................................................TTT...........T
TTTTTTT...TTTTTTTT...................................................................TTT...........T
T...............TTT..................................................................TTT...........T
T................TTT.................................................................TTT...........T
T.................TTT................................................................TTT...........T
T..................TTT...............................................................TTT...........T
T...................TTTT.......TTTTTTTTTTTTTTTTTTTTTTTTTTTTTTTT....TT................TTT...........T
T....................TTTT......TTTTTTTTTTTTTTTTTTTTTTTTTTTT........TT................TTT...........T
T.....................TTT......TTTTTTTTTTTTTTTTTTTTTTTTT...........TT.................T............T
T......................TT......TTT.................................TT..............................T
T......................TT......TTT.................................TT..............................T
T......................TT......TTT.................................TT..............................T
T......................TT......TTT.................................TT..............................T
T......................TT......TTT.................................TT.................T............T
T......................TT......TTT.................................TT................TTT...........T
T......................TT......TTT.................................TT................TTT...........T
T......................TT......TTT.................................TT................TTT...........T
T......................TT......TTT.................................TT................TTT...........T
T......................TT......TTT.................................TT................TTT...........T
T......................TT......TTT.................................TT................TTT...........T
T......................TT......TTT.................................TT................TTTTTTTTTTTTTTT
T......................TT..........................................TT................TTTTTTTTTTTTTTT
T......................TT..........................................TT................TTTTTTTTTTTTTTT
T......................TT..........................................TT................TTTTTTTTTTTTTTT
T......................TT......TTT.................................TT..............................T
T......................TT......TTT.................................TT..............................T
T...................TTTTT......TTT.................................TT..............................T
T.................TTTTT........TTT.................................TT..............................T
T...............TTT............TTT.................................TT..............................T
T..............TTT.............TTTTTTTTTTTTTTTTTTTTTTTTTTTTTTTTTTTTTT..............................T
T...........TTT................TTTTTTTTTTTTTTTTTTTTTTTTTTTTTTTTTTTTTT..............TTTTTTTTTTTTTTTTT
T.........TTT....................................................................TTTTTTTTTTTTTTTTTTT
T.......TTT...................................................................TTTTTT...............T
T.....TTT......................................................................TTT.................T
T...TTT...................................................................T........................T
T.TTT...................................................................TTTT.......................T
TTTT....................................................................TTTT.......................T
T.....................................................................TTT..........................T
T.....................................................................TTT..........................T
T...................................................................TTT............................T
T..................................................................TTT.............................T
T.................................................................TTT..............................T
T............TTTTTTTT.........TTTTTTTTTTT........................TTT...............................T
T............TTTTTTTTTTT......TTTTTTTTTTT......................TTT.................................T
T............TTTTTTTTTTT......TTTTTTTTTTT......................TTT.................................T
T............TTT.....................TTTT.....................TTT..................................T
T............TTT.....................TTTT.....................TTT..................................T
TT...........TTT.....................TTTT....................TTT...................................T
TTTTT....TTTTTTT.....................TTTT....................TTT...................................T
TTTT......TTTTTT.....................TTTT....................TTT...................................T
T..........TTTTT.....................TTTT...................TTT....................................T
T............TTT.....................TTTT...................TTT....................................T
T............TTT.....................TTTT..................TTT.....................................T
T............TTT.....................TTTT..................TTT.....................................T
T............TTT.....................TTTT..................TTT.....................................T
T............TTT.....................TTTT.................TTT......................................T
T............TTT.....................TTTT................TTT.......................................T
T............TTT.....................TTTT................TTT.......................................T
T............TTT.....................TTTT................TTT.......................................T
T.............T......................TTTT..........................................................T
T....................................TTTT..........................................................T
T....................................TTTT...............TTT........................................T
T....................................TTTT...............TTT........................................T
T............TTT.....................TTTT...............TTT........................................T
T............TTT.....................TTTT...............TTT........................................T
TTTTTTTTTTTTTTTTTTTTTTTTTTTTTTTTTTTTTTTTTTTTTTTTTTTTTTTTTTTTTTTTTTTTTTTTTTTTTTTTTTTTTTTTTTTTTTTTTTTT

