type octile
height 70
width 70
map
TTTTTTTTTTTTTTTTTTTTTTTTTTTTTTTTTTTTTTTTTTTTTTTTTTTTTTTTTTTTTTTTTTTTT
T...................................................................T
T...................................................................T
T...................................................................T
T...................................................................T
T...................................................................T
T...................................................................T
T...................................................................T
T...................................................................T
T...................................................................T
T...................................................................T
T...................................................................T
T...................................................................T
T...................................................................T
T...................................................................T
T...................................................................T
T...................................................................T
T...................................................................T
T...................................................................T
T...................................................................T
T...................................................................T
T...................................................................T
T...................................................................T
T...................................................................T
T...................................................................T
T...................................................................T
T...................................................................T
T...................................................................T
T...................................................................T
T...................................................................T
T...................................................................T
T...................................................................T
T...................................................................T
T...................................................................T
T...................................................................T
T...................................................................T
T...................................................................T
T...................................................................T
T...................................................................T
T...................................................................T
T...................................................................T
T...................................................................T
T...................................................................T
T...................................................................T
T...................................................................T
T...................................................................T
T...................................................................T
T...................................................................T
T...................................................................T
T...................................................................T
T...................................................................T
T...................................................................T
T...................................................................T
T...................................................................T
T...................................................................T
T...................................................................T
T...................................................................T
T...................................................................T
T...................................................................T
T...................................................................T
T...................................................................T
T...................................................................T
T...................................................................T
T...................................................................T
T...................................................................T
T...................................................................T
T...................................................................T
T...................................................................T
T...................................................................T
TTTTTTTTTTTTTTTTTTTTTTTTTTTTTTTTTTTTTTTTTTTTTTTTTTTTTTTTTTTTTTTTTTTTT
