type octile
height 4
width 11
map
TTTTTTTTTTT
T...T...T.T
TTT...T...T
TTTTTTTTTTT
