type octile
height 80
width 100
map
TTTTTTTTTTTTTTTTTTTTTTTTTTTTTTTTTTTTTTTTTTTTTTTTTTTTTTTTTTTTTTTTTTTTTTTTTTTTTTTTTTTTTTTTTTTTTTTTTTTTTTTTTTTTTTTTTTTTTTTTTTTTTTTTTTTTTTTTTTTTTTTTTTTTTTTTTTTTTTTTTTTTTTTTTTTTTTTTTTTTTTTTTTTTTTTTTTTTTTTT
T...................................TTTTT...................................TT.....................TT........................................................................TT........................T
T...................................TTTT....................................TT.....................TT........................................................................TT........................T
T...................................TTT.....................................TT...............................................................................................TT........................T
T...................................TT......................................TT...............................................................................................TT........................T
T...................................T.......................................TT.....................TT........................................................................TT........................T
T...........................................................................TT.....................TT........................................................................TT........................T
T...........................................................................TT.....................TT........................................................................TTTTTTTTTTTTTTTTT....TTTTTT
T...................................T.......................................TT.......TTTTTTTTTTTTTTTTTTTTTTTTTTTTT.....................................................................................T
T...................................TT......................................TT.......TTTTTTTTTTTTTTTTTTTTTTTTTTTTT.....................................................................................T
T...................................TTT.....................................TT.......TTT.......................TTT.....................................................................................T
T...................................TTTT....................................TT.......TTT.......................TTT.....................................................................................T
T...................................TTTTT...................................TT.......TTT.......................TTT................TTTTTTTTTTTTTTTTTTTTTTTTTTTTTTTTTTTTTTTTTTTTTTTTTTTTTTTTTTTTTTTTTTTTTT
T...................................TTTTTTTTTTTTTTTTTTTTTTTTTTTTTTTTTTTT.............TTT.......................TTT................TTTTTTTTTTTTTTTTTTTTTTTTTTTTTTTTTTTTTTTTTTTTTTTTTTTTTTTTTTTTTTTTTTTTTT
T....................................................................................TTT.......................TTT................TTT..................................................................T
TTTTTT....TTTTTTT....................................................................TTT...................... TTT................TTT..................................................................T
TTTTTTT...TTTTTTTT...................................................................TTT...................... TTT................TTT..................................................................T
T...............TTT..................................................................TTT.......................TTT................TTT..................................................................T
T................TTT.................................................................TTT.......................TTT................TTT..................................................................T
T.................TTT................................................................TTT.......................TTT................TTT..................................................................T
T..................TTT...............................................................TTT.......................TTT................TTT..................................................................T
T...................TTTT.......TTTTTTTTTTTTTTTTTTTTTTTTTTTTTTTT....TT................TTT.......................TTT................TTT..................................................................T
T....................TTTT......TTTTTTTTTTTTTTTTTTTTTTTTTTTT........TT................TTT.......................TTT................TTTTTTTTTTTTTTTTTTTTTTTT.........TTTTT...............................T
T.....................TTT......TTTTTTTTTTTTTTTTTTTTTTTTT...........TT.................T........................TTT................TTTTTTTTTTTTTTTTTTTTTTTT.........TTTTT...............................T
T......................TT......TTT.................................TT..........................................TTT................TTT.................................TT...............................T
T......................TT......TTT.................................TT..........................................TTT................TTT.................................TT...............................T
T......................TT......TTT.................................TT..........................................TTT................TTT.................................TT...............................T
T......................TT......TTT.................................TT..........................................TTT................TTT.................................TT...............................T
T......................TT......TTT.................................TT.................T........................TTT................TTT.................................TT...............................T
T......................TT......TTT.................................TT................TTT.......................TTT................TTT.................................TT...............................T
T......................TT......TTT.................................TT................TTT.......................TTT................TTT.................................TT...............................T
T......................TT......TTT.................................TT................TTT.......................TTT................TTT.................................TT...............................T
T......................TT......TTT.................................TT................TTT.......................TTT................TTT.................................TT...............................T
T......................TT......TTT.................................TT................TTT.......................TTT................TTT.................................TT...............................T
T......................TT......TTT.................................TT................TTT.......................TTT................TTT.................................TT...............................T
T......................TT......TTT.................................TT................TTTTTTTTTTTTTTTTTTTTTTTTTTTTT................TTT.................................TT...............................T
T......................TT..........................................TT................TTTTTTTTTTTTTTTTTTTTTTTTTTTTT................TTT.................................TT...............................T
T......................TT..........................................TT................TTTTTTTTTTTTTTTTTTTTTTTTTTTTT................TTT.................................TT...............................T
T......................TT..........................................TT................TTTTTTTTTTTTTTTTTTTTTTTTTTTTT................TTT.................................TT...............................T
T......................TT......TTT.................................TT..............................TT.............................TTT.................................TT...............................T
T......................TT......TTT.................................TT..............................TT.............................TTT.................................TT...............................T
T...................TTTTT......TTT.................................TT..............................TT.............................TTT.................................TT...............................T
T.................TTTTT........TTT.................................TT..............................TT.............................TTT.................................TT...............................T
T...............TTT............TTT.................................TT..............................TT.............................TTT.................................TT...............................T
T..............TTT.............TTTTTTTTTTTTTTTTTTTTTTTTTTTTTTTTTTTTTT..............................TT.............................TTTTTTTTTTTTTTTTTTTTTTTTTTTTTTTTTTTTTT...............................T
T...........TTT................TTTTTTTTTTTTTTTTTTTTTTTTTTTTTTTTTTTTTT..............TTTTTTTTTTTTTTTTTT.............................TTTTTTTTTTTTTTTTTTTTTTTTTTTTTTTTTTTTTT...............................T
T.........TTT....................................................................TTTTTTTTTTTTTTTTTTTT.................................................................TT...............................T
T.......TTT...................................................................TTTTTT...............TT.................................................................TT...............................T
T.....TTT......................................................................TTT.................TT.................................................................TT...............................T
T...TTT...................................................................T........................TT.................................................................TT...............................T
T.TTT...................................................................TTTT.......................T..................................................................TT...............................T
TTTT....................................................................TTTT.......................TTTTTTTTTTTTTTTTTTTTTTTTTTTTTTTTTTTTTTTTTTTTTTTTTTTTTT.............TT...............................T
T.....................................................................TTT..........................TTTTTTTTTTTTTTTTTTTTTTTTTTTTTTTTTTTTTTTTTTTTTTTTTTTTTT.............TT...............................T
T.....................................................................TTT..........................TTTTTTTTTTTTTTTTTTTTTTTTTTTTTTTTTTTTTTTTTTTTTTTTTTTTTT.............TT...............................T
T...................................................................TTT............................TT.................................................................TT...............................T
T..................................................................TTT.............................TT.................................................................TT...............................T
T.................................................................TTT..............................TT.................................................................TT...............................T
T............TTTTTTTT.........TTTTTTTTTTT........................TTT...............................TT.................................................................TT...............................T
T............TTTTTTTTTTT......TTTTTTTTTTT......................TTT.................................TT.................................................................TT...............................T
T............TTTTTTTTTTT......TTTTTTTTTTT......................TTT.................................TT.................................................................TT...............................T
T............TTT.....................TTTT.....................TTT..................................TT.................................................................TT...............................T
T............TTT.....................TTTT.....................TTT..................................TT.................................................................TT...............................T
TT...........TTT.....................TTTT....................TTT...................................TT.................................................................TT...............................T
TTTTT....TTTTTTT.....................TTTT....................TTT...................................TTTTTTTTTTTTTTTTTTTTTTTTTTTTTTTTTTTTTTTTTTTTTTTTTTTTTTTTTTTTTTTTTTTTT...............................T
TTTT......TTTTTT.....................TTTT....................TTT...................................TTTTTTTTTTTTTTTTTTTTTTTTTTTTTTTTTTTTTTTTTTTTTTTTTTTTTTTTTTTTTTTTTTTTT...............................T
T..........TTTTT.....................TTTT...................TTT....................................TT..................................................................................................T
T............TTT.....................TTTT...................TTT....................................TT..................................................................................................T
T............TTT.....................TTTT..................TTT.....................................TT..................................................................................................T
T............TTT.....................TTTT..................TTT.....................................TT..................................................................................................T
T............TTT.....................TTTT..................TTT.....................................TT..................................................................................................T
T............TTT.....................TTTT.................TTT......................................TT..................................................................................................T
T............TTT.....................TTTT................TTT.......................................TT..................................................................................................T
T............TTT.....................TTTT................TTT.......................................TT..................................................................................................T
T............TTT.....................TTTT................TTT.......................................TT..................................................................................................T
T.............T......................TTTT..............................................................................................................................................................T
T....................................TTTT..............................................................................................................................................................T
T....................................TTTT...............TTT............................................................................................................................................T
T....................................TTTT...............TTT........................................TT..................................................................................................T
T............TTT.....................TTTT...............TTT........................................TT..................................................................................................T
T............TTT.....................TTTT...............TTT........................................TT..................................................................................................T
TTTTTTTTTTTTTTTTTTTTTTTTTTTTTTTTTTTTTTTTTTTTTTTTTTTTTTTTTTTTTTTTTTTTTTTTTTTTTTTTTTTTTTTTTTTTTTTTTTTTTTTTTTTTTTTTTTTTTTTTTTTTTTTTTTTTTTTTTTTTTTTTTTTTTTTTTTTTTTTTTTTTTTTTTTTTTTTTTTTTTTTTTTTTTTTTTTTTTTTT












