type octile
height 140
width 200
map
TTTTTTTTTTTTTTTTTTTTTTTTTTTTTTTTTTTTTTTTTTTTTTTTTTTTTTTTTTTTTTTTTTTTTTTTTTTTTTTTTTTTTTTTTTTTTTTTTTTTTTTTTTTTTTTTTTTTTTTTTTTTTTTTTTTTTTTTTTTTTTTTTTTTTTTTTTTTTTTTTTTTTTTTTTTTTTTTTTTTTTTTTTTTTTTTTTTTTTTT
T..................................................................................................T...................................................................................................T
T..................................................................................................T...................................................................................................T
T..................................................................................................T...................................................................................................T
T..................................................................................................T...................................................................................................T
T..................................................................................................T...................................................................................................T
T..................................................................................................T...................................................................................................T
T..................................................................................................T...................................................................................................T
T..................................................................................................T...................................................................................................T
T..................................................................................................T...................................................................................................T
T..................................................................................................T...................................................................................................T
T..................................................................................................T...................................................................................................T
T..................................................................................................T...................................................................................................T
T..................................................................................................T...................................................................................................T
T..................................................................................................T...................................................................................................T
T..................................................................................................T...................................................................................................T
T..................................................................................................T...................................................................................................T
T..................................................................................................T...................................................................................................T
T..................................................................................................T...................................................................................................T
T..................................................................................................T...................................................................................................T
T..................................................................................................T...................................................................................................T
T..................................................................................................T...................................................................................................T
T..................................................................................................T...................................................................................................T
T..................................................................................................T...................................................................................................T
T..................................................................................................T...................................................................................................T
T..................................................................................................T...................................................................................................T
T..................................................................................................T...................................................................................................T
T..................................................................................................T...................................................................................................T
T..................................................................................................T...................................................................................................T
T..................................................................................................T...................................................................................................T
TTTTTTTTTTTTTTTTTTTTTTTTTTTTTTTTTTTTTTTTTTTTTTTTTTTTTTT..........TTTTTTTTTTTTTTTTTTTTTTT.........TTTTT..........TTTTTTTTTTTTTTTTTTTTTTT..........TTTTTTTTTTTTTTTTTTTTTTTTTTTTTTTTTTTTTTTTTTTTTTTTTTTTTTT
TTTTTTTTTTTTTTTTTTTTTTTTTTTTTTTTTTTTTTTTTTTTTTTTTTTTTTT..........TTTTTTTTTTTTTTTTTTTTTTT.........TTTTT..........TTTTTTTTTTTTTTTTTTTTTTT..........TTTTTTTTTTTTTTTTTTTTTTTTTTTTTTTTTTTTTTTTTTTTTTTTTTTTTTT
T........................................TTTTTTTTTT..................................................................................................TTTTTTTTTT........................................T
T........................................TTTTTTTTTT..................................................................................................TTTTTTTTTT........................................T
T........................................TTTTTTTTTT..................................................................................................TTTTTTTTTT........................................T
T........................................TTTTTTTTTT..................................................................................................TTTTTTTTTT........................................T
T........................................TTTTTTTTTT....................TTTTTTTTTTT....................................TTTTTTTTTTT....................TTTTTTTTTT........................................T
T........................................TTTTTTTTTT................TTTTTTTTTTTTTTTTTT.............................TTTTTTTTTTTTTTTTTT.................TTTTTTTTTT........................................T
T........................................TTT....................TTTT................TTTT.......................TTTT................TTTT.....................TTT........................................T
T........................................TTT.................TTTT......................TTTT.................TTTT......................TTTT..................TTT........................................T
T........................................TTT................TTT..........................TTT...............TTT..........................TTT.................TTT........................................T
T........................................TTT...............TTT............................TTT.............TTT............................TTT................TTT........................................T
T........................................TTT..............TTT..............................TTT...........TTT..............................TTT...............TTT........................................T
T........................................TTT.............TTT................................TTT.........TTT................................TTT..............TTT........................................T
T........................................TTT.............TT..................................TT.........TT..................................TT..............TTT........................................T
T........................................TTT.............TT..................................TT.........TT..................................TT..............TTT........................................T
T........................................TTT.............TT..................................TT.........TT..................................TT..............TTT........................................T
T........................................TTT.............TT..................................TT.........TT..................................TT..............TTT........................................T
T........................................................TT..................................TT.........TT..................................TT.........................................................T
T........................................................TT..................................TT.........TT..................................TT.........................................................T
T............................................................................................TT.........TT.............................................................................................T
T........................................TTT.................................................TT.........TT..................................................TTT........................................T
T........................................TTT.................................................TT.........TT..................................................TTT........................................T
T........................................TTT.................................................TT.........TT..................................................TTT........................................T
T........................................TTT.................................................TT.........TT..................................................TTT........................................T
TTTTTTTTTTTTTTTTTTTTTTTTTTTTTTTTTTTTTTTTTTTT.............TT..................................TT.........TT..................................TT..............TTTTTTTTTTTTTTTTTTTTTTTTTTTTTTTTTTTTTTTTTTTT
T........................................TTT.............TT..................................TT.........TT..................................TT..............TTT........................................T
T........................................TTT.............TT..................................TT.........TT..................................TT..............TTT........................................T
T........................................TTT.............TT..................................TT.........TT..................................TT..............TTT........................................T
T........................................TTT.............TT..................................TT.........TT..................................TT..............TTT........................................T
T........................................................TT..................................TT.........TT..................................TT.........................................................T
T........................................................TT..................................TT.........TT..................................TT.........................................................T
T........................................................TTT................................TTT.........TTT................................TTT.........................................................T
T........................................TTT..............TTT..............................TTT...........TTT..............................TTT...............TTT........................................T
T........................................TTT...............TTT............................TTT.............TTT............................TTT................TTT........................................T
T........................................TTT................TTT..........................TTT...............TTT..........................TTT.................TTT........................................T
T........................................TTT.................TTTT......................TTTT.................TTTT......................TTTT..................TTT........................................T
T........................................TTT....................TTTT................TTTT.......................TTTT................TTTT.....................TTT........................................T
T........................................TTT.......................TTTTTTTTTTTTTTTTTT.............................TTTTTTTTTTTTTTTTTT........................TTT........................................T
T........................................TTT................................................................................................................TTT........................................T
T........................................TTT................................................................................................................TTT........................................T
T........................................TTT................................................................................................................TTT........................................T
T........................................TTT................................................................................................................TTT........................................T
TTTTTTTTTTTTTTTTTTTTTTTTTTTTTTTTTTTTTTTTTTTT................................................................................................................TTTTTTTTTTTTTTTTTTTTTTTTTTTTTTTTTTTTTTTTTTTT
T........................................TTT................................................................................................................TTT........................................T
T........................................TTT................................................................................................................TTT........................................T
T........................................TTT................................................................................................................TTT........................................T
T........................................TTT................................................................................................................TTT........................................T
T........................................TTT...........................TTTTTTTTTTT....................................TTTTTTTTTTT...........................TTT........................................T
T........................................TTT.......................TTTTTTTTTTTTTTTTTT.............................TTTTTTTTTTTTTTTTTT........................TTT........................................T
T........................................TTT....................TTTT................TTTT.......................TTTT................TTTT.....................TTT........................................T
T........................................TTT.................TTTT......................TTTT.................TTTT......................TTTT..................TTT........................................T
T........................................TTT................TTT..........................TTT...............TTT..........................TTT.................TTT........................................T
T........................................TTT...............TTT............................TTT.............TTT............................TTT................TTT........................................T
T.........................................................TTT..............................TTT...........TTT..............................TTT..........................................................T
T........................................................TTT................................TTT.........TTT................................TTT.........................................................T
T........................................................TT..................................TT.........TT..................................TT.........................................................T
T........................................TTT.............TT..................................TT.........TT..................................TT..............TTT........................................T
T........................................TTT.............TT..................................TT.........TT..................................TT..............TTT........................................T
T........................................TTT.............TT..................................TT.........TT..................................TT..............TTT........................................T
T........................................TTT.............TT..................................TT.........TT..................................TT..............TTT........................................T
TTTTTTTTTTTTTTTTTTTTTTTTTTTTTTTTTTTTTTTTTTTT.............TT..................................TT.........TT..................................TT..............TTTTTTTTTTTTTTTTTTTTTTTTTTTTTTTTTTTTTTTTTTTT
T........................................TTT.................................................TT.........TT..................................................TTT........................................T
T........................................TTT.................................................TT.........TT..................................................TTT........................................T
T........................................TTT.................................................TT.........TT..................................................TTT........................................T
T........................................TTT.................................................TT.........TT..................................................TTT........................................T
T............................................................................................TT.........TT.............................................................................................T
T........................................................TT..................................TT.........TT..................................TT.........................................................T
T........................................................TT..................................TT.........TT..................................TT.........................................................T
T........................................TTT.............TT..................................TT.........TT..................................TT..............TTT........................................T
T........................................TTT.............TT..................................TT.........TT..................................TT..............TTT........................................T
T........................................TTT.............TT..................................TT.........TT..................................TT..............TTT........................................T
T........................................TTT.............TT..................................TT.........TT..................................TT..............TTT........................................T
T........................................TTT.............TT..................................TT.........TT..................................TT..............TTT.......................................TT
T........................................TTT.............TTT................................TTT.........TTT................................TTT..............TTT........................................T
T........................................TTT..............TTT..............................TTT...........TTT..............................TTT...............TTT........................................T
T........................................TTT...............TTT............................TTT.............TTT............................TTT................TTT........................................T
T........................................TTT................TTT..........................TTT...............TTT..........................TTT.................TTT........................................T
T........................................TTT.................TTTT......................TTTT.................TTTT......................TTTT..................TTT........................................T
T........................................TTTTTTTTTT.............TTTT................TTTT.......................TTTT................TTTT..............TTTTTTTTTT........................................T
T........................................TTTTTTTTTT................TTTTTTTTTTTTTTTTTT.............................TTTTTTTTTTTTTTTTTT.................TTTTTTTTTT........................................T
T........................................TTTTTTTTTT..................................................................................................TTTTTTTTTT........................................T
T........................................TTTTTTTTTT..................................................................................................TTTTTTTTTT........................................T
T........................................TTTTTTTTTT..................................................................................................TTTTTTTTTT........................................T
T........................................TTTTTTTTTT..................................................................................................TTTTTTTTTT........................................T
TTTTTTTTTTTTTTTTTTTTTTTTTTTTTTTTTTTTTTTTTTTTTTTTTTTTTTTTTTTTTTTTTTTTTTTTTTT.........TTTTTTTTTTTTTTTTTTTTTTTTTTTTTTT.........TTTTTTTTTTTTTTTTTTTTTTTTTTTTTTTTTTTTTTTTTTTTTTTTTTTTTTTTTTTTTTTTTTTTTTTTTTTT
TTTTTTTTTTTTTTTTTTTTTTTTTTTTTTTTTTTTTTTTTTTTTTTTTTTTTTTTTTTTTTTTTTTTTTTTTTT.........TTTTTTTTTTTTTTTTTTTTTTTTTTTTTTT.........TTTTTTTTTTTTTTTTTTTTTTTTTTTTTTTTTTTTTTTTTTTTTTTTTTTTTTTTTTTTTTTTTTTTTTTTTTTT
T.......................................................T..........................................T...........................................T.......................................................T
T.......................................................T..........................................T...........................................T.......................................................T
T.......................................................T..........................................T...........................................T.......................................................T
T.......................................................T..........................................T...........................................T.......................................................T
T.......................................................T..........................................T...........................................T.......................................................T
T..................................................................................................T...................................................................................................T
T..................................................................................................T...................................................................................................T
T..................................................................................................T...................................................................................................T
T.......................................................T..........................................T...........................................T.......................................................T
T.......................................................T..........................................T...........................................T.......................................................T
T.......................................................T..........................................T...........................................T.......................................................T
T.......................................................T..........................................T...........................................T.......................................................T
T.......................................................T..........................................T...........................................T.......................................................T
T.......................................................T..........................................T...........................................T.......................................................T
T.......................................................T..........................................T...........................................T.......................................................T
T.......................................................T..........................................T...........................................T.......................................................T
T.......................................................T..........................................T...........................................T.......................................................T
T.......................................................T..........................................T...........................................T.......................................................T
T.......................................................T..........................................T...........................................T.......................................................T
T.......................................................T..........................................T...........................................T.......................................................T
T.......................................................T..........................................T...........................................T.......................................................T
T.......................................................T..........................................T...........................................T.......................................................T
TTTTTTTTTTTTTTTTTTTTTTTTTTTTTTTTTTTTTTTTTTTTTTTTTTTTTTTTTTTTTTTTTTTTTTTTTTTTTTTTTTTTTTTTTTTTTTTTTTTTTTTTTTTTTTTTTTTTTTTTTTTTTTTTTTTTTTTTTTTTTTTTTTTTTTTTTTTTTTTTTTTTTTTTTTTTTTTTTTTTTTTTTTTTTTTTTTTTTTTT



































