type octile
height 30
width 30
map
TTTTTTTTTTTTTTTTTTTTTTTTTTTTTT
T............................T
T............................T
T............................T
T............................T
T............................T
T............................T
T......TTTTTTTTT.............T
T..............T.............T
T..............T.............T
T..............T.............T
T..............T.............T
T..............T.............T
T..............T.............T
T..............T.............T
T..............T.............T
T..............T.............T
T..............T.............T
T..............T.............T
T..............T.............T
T..............T.............T
T..............T.............T
T......TTTTTTTTT.............T
T............................T
T............................T
T............................T
T............................T
T............................T
T............................T
TTTTTTTTTTTTTTTTTTTTTTTTTTTTTT
