type octile
height 60
width 100
map
TTTTTTTTTTTTTTTTTTTTTTTTTTTTTTTTTTTTTTTTTTTTTTTTTTTTTTTTTTTTTTTTTTTTTTTTTTTTTTTTTTTTTTTTTTTTTTTTTTTT
T..................T...............T...............T...............T...............T...............T
T..................T...............T...............T...............T...............T...............T
T..................T...............T...............T...............T...............T...............T
T......TTTTTTTTT...T...TTTTTTTTT...T...TTTTTTTTT...T...TTTTTTTTT...T...TTTTTTTTT...T...TTTTTTTTT...T
T......T.......T...T...T.......T...T...T.......T...T...T.......T...T...T.......T...T...T.......T...T
T......T.......T...T...T.......T...T...T.......T...T...T.......T...T...T.......T...T...T.......T...T
T......T.......T...T...T.......T...T...T.......T...T...T.......T...T...T.......T...T...T.......T...T
T......T...T...T...T...T...T...T...T...T...T...T...T...T...T...T...T...T...T...T...T...T...T...T...T
T......T...T...T...T...T...T...T...T...T...T...T...T...T...T...T...T...T...T...T...T...T...T...T...T
T......T...T...T...T...T...T...T...T...T...T...T...T...T...T...T...T...T...T...T...T...T...T...T...T
T......T...T...T...T...T...T...T...T...T...T...T...T...T...T...T...T...T...T...T...T...T...T...T...T
T......T...T...T...T...T...T...T...T...T...T...T...T...T...T...T...T...T...T...T...T...T...T...T...T
T......T...T...T...T...T...T...T...T...T...T...T...T...T...T...T...T...T...T...T...T...T...T...T...T
T......T...T...T...T...T...T...T...T...T...T...T...T...T...T...T...T...T...T...T...T...T...T...T...T
T......T...T...T...T...T...T...T...T...T...T...T...T...T...T...T...T...T...T...T...T...T...T...T...T
T......T...T...T...T...T...T...T...T...T...T...T...T...T...T...T...T...T...T...T...T...T...T...T...T
T......T...T...T...T...T...T...T...T...T...T...T...T...T...T...T...T...T...T...T...T...T...T...T...T
T......T...T...T...T...T...T...T...T...T...T...T...T...T...T...T...T...T...T...T...T...T...T...T...T
T......T...T...T...T...T...T...T...T...T...T...T...T...T...T...T...T...T...T...T...T...T...T...T...T
T......T...T...T...T...T...T...T...T...T...T...T...T...T...T...T...T...T...T...T...T...T...T...T...T
T......T...T...T...T...T...T...T...T...T...T...T...T...T...T...T...T...T...T...T...T...T...T...T...T
T......T...T...T...T...T...T...T...T...T...T...T...T...T...T...T...T...T...T...T...T...T...T...T...T
T......T...T...T...T...T...T...T...T...T...T...T...T...T...T...T...T...T...T...T...T...T...T...T...T
T......T...T...T...T...T...T...T...T...T...T...T...T...T...T...T...T...T...T...T...T...T...T...T...T
T......T...T...T...T...T...T...T...T...T...T...T...T...T...T...T...T...T...T...T...T...T...T...T...T
T......T...T...T...T...T...T...T...T...T...T...T...T...T...T...T...T...T...T...T...T...T...T...T...T
T......T...T...T...T...T...T...T...T...T...T...T...T...T...T...T...T...T...T...T...T...T...T...T...T
T......T...T...T...T...T...T...T...T...T...T...T...T...T...T...T...T...T...T...T...T...T...T...T...T
T......T...T...T...T...T...T...T...T...T...T...T...T...T...T...T...T...T...T...T...T...T...T...T...T
T......T...T...T...T...T...T...T...T...T...T...T...T...T...T...T...T...T...T...T...T...T...T...TTTTT
T......T...T...T...T...T...T...T...T...T...T...T...T...T...T...T...T...T...T...T...T...T...T...T...T
T......T...T...T...T...T...T...T...T...T...T...T...T...T...T...T...T...T...T...T...T...T...T...T...T
T......T...T...T...T...T...T...T...T...T...T...T...T...T...T...T...T...T...T...T...T...T...T...T...T
T......T...T...T...T...T...T...T...T...T...T...T...T...T...T...T...T...T...T...T...T...T...T...T...T
T......T...T...T...T...T...T...T...T...T...T...T...T...T...T...T...T...T...T...T...T...T...T...T...T
T......T...T...T...T...T...T...T...T...T...T...T...T...T...T...T...T...T...T...T...T...T...T...T...T
T......T...T...T...T...T...T...T...T...T...T...T...T...T...T...T...T...T...T...T...T...T...T...T...T
T......T...T...T...T...T...T...T...T...T...T...T...T...T...T...T...T...T...T...T...T...T...T...T...T
T......T...T...T...T...T...T...T...T...T...T...T...T...T...T...T...T...T...T...T...T...T...T...T...T
T......T...T...T...T...T...T...T...T...T...T...T...T...T...T...T...T...T...T...T...T...T...T...T...T
T......T...T...T...T...T...T...T...T...T...T...T...T...T...T...T...T...T...T...T...T...T...T...T...T
T......T...T...T...T...T...T...T...T...T...T...T...T...T...T...T...T...T...T...T...T...T...T...T...T
T......T...T...T...T...T...T...T...T...T...T...T...T...T...T...T...T...T...T...T...T...T...T...T...T
T......T...T...T...T...T...T...T...T...T...T...T...T...T...T...T...T...T...T...T...T...T...T...T...T
T......T...T...T...T...T...T...T...T...T...T...T...T...T...T...T...T...T...T...T...T...T...T...T...T
T......T...T...T...T...T...T...T...T...T...T...T...T...T...T...T...T...T...T...T...T...T...T...T...T
T......T...T...T...T...T...T...T...T...T...T...T...T...T...T...T...T...T...T...T...T...T...T...T...T
T......T...T...T...T...T...T...T...T...T...T...T...T...T...T...T...T...T...T...T...T...T...T...T...T
T......T...T...T...T...T...T...T...T...T...T...T...T...T...T...T...T...T...T...T...T...T...T...T...T
T......T...T...T...T...T...T...T...T...T...T...T...T...T...T...T...T...T...T...T...T...T...T...T...T
T......T...T...T...T...T...T...T...T...T...T...T...T...T...T...T...T...T...T...T...T...T...T...T...T
T......T...T...T.......T...T...T.......T...T...T.......T...T...T.......T...T...T.......T...T...T...T
T......T...T...T.......T...T...T.......T...T...T.......T...T...T.......T...T...T.......T...T...T...T
T......T...T...T.......T...T...T.......T...T...T.......T...T...T.......T...T...T.......T...T...T...T
T......T...T...TTTTTTTTT...T...TTTTTTTTT...T...TTTTTTTTT...T...TTTTTTTTT...T...TTTTTTTTT...T...T...T
T..........T...............T...............T...............T...............T...............T.......T
T..........T...............T...............T...............T...............T...............T.......T
T..........T...............T...............T...............T...............T...............T.......T
TTTTTTTTTTTTTTTTTTTTTTTTTTTTTTTTTTTTTTTTTTTTTTTTTTTTTTTTTTTTTTTTTTTTTTTTTTTTTTTTTTTTTTTTTTTTTTTTTTTT