type octile
height 33
width 40
map
TTTTTTTTTTTTTTTTTTTTTTTTTTTTTTTTTTTTTTTT
T......................................T
T......................................T
T......................................T
T...TTTTTTTTTTTTTTTTTTTTTTTTTTTTTTTT...T
T...T..............................T...T
T...T..............................T...T
T...T..............................T...T
T...T...TTTTTTTTTTTTTTTTTTTTTTTT...T...T
T...T...T......................T...T...T
T...T...T......................T...T...T
T...T...T......................T...T...T
T...T...T...TTTTTTTTTTTTTTTT...T...T...T
T...T...T...T..............T...T...T...T
T...T...T...T..............T...T...T...T
T...T...T...T..............T...T...T...T
T...T...T...T...TTTTTTTT...T...T...T...T
T...T...T...T..........T...T...T...T...T
T...T...T...T..........T...T...T...T...T
T...T...T...T..........T...T...T...T...T
T...T...T...TTTTTTTTTTTT...T...T...T...T
T...T...T..................T...T...T...T
T...T...T..................T...T...T...T
T...T...T..................T...T...T...T
T...T...TTTTTTTTTTTTTTTTTTTT...T...T...T
T...T..........................T...T...T
T...T..........................T...T...T
T...T..........................T...T...T
T...TTTTTTTTTTTTTTTTTTTTTTTTTTTT...T...T
T..................................T...T
T..................................T...T
T..................................T...T
TTTTTTTTTTTTTTTTTTTTTTTTTTTTTTTTTTTTTTTT
