type octile
height 20
width 28
map
TTTTTTTTTTTTTTTTTTTTTTTTTTTT
T........TT................T
T........TT................T
T........T......T..........T
T...............T..........T
T...............T..........T
T........T......T..........T
T........T......T..........T
T........T...TTTTTTTTTTTTT.T
T....................T.....T
T....................T.....T
TTTT....TTTTT........T.....T
T...........TT.............T
T............TT............T
T.............TT.....T.....T
T..TTTTTTT.....TT....T.....T
T...............TT...T.....T
T....................T.....T
T................TT..T.....T
TTTTTTTTTTTTTTTTTTTTTTTTTTTT



