type octile
height 60
width 52
map
TTTTTTTTTTTTTTTTTTTTTTTTTTTTTTTTTTTTTTTTTTTTTTTTTTTT
T..................T...............T...............T
T..................T...............T...............T
T..................T...............T...............T
T......TTTTTTTTT...T...TTTTTTTTT...T...TTTTTTTTT...T
T......T.......T...T...T.......T...T...T.......T...T
T......T.......T...T...T.......T...T...T.......T...T
T......T.......T...T...T.......T...T...T.......T...T
T......T...T...T...T...T...T...T...T...T...T...T...T
T......T...T...T...T...T...T...T...T...T...T...T...T
T......T...T...T...T...T...T...T...T...T...T...T...T
T......T...T...T...T...T...T...T...T...T...T...T...T
T......T...T...T...T...T...T...T...T...T...T...T...T
T......T...T...T...T...T...T...T...T...T...T...T...T
T......T...T...T...T...T...T...T...T...T...T...T...T
T......T...T...T...T...T...T...T...T...T...T...T...T
T......T...T...T...T...T...T...T...T...T...T...T...T
T......T...T...T...T...T...T...T...T...T...T...T...T
T......T...T...T...T...T...T...T...T...T...T...T...T
T......T...T...T...T...T...T...T...T...T...T...T...T
T......T...T...T...T...T...T...T...T...T...T...T...T
T......T...T...T...T...T...T...T...T...T...T...T...T
T......T...T...T...T...T...T...T...T...T...T...T...T
T......T...T...T...T...T...T...T...T...T...T...T...T
T......T...T...T...T...T...T...T...T...T...T...T...T
T......T...T...T...T...T...T...T...T...T...T...T...T
T......T...T...T...T...T...T...T...T...T...T...T...T
T......T...T...T...T...T...T...T...T...T...T...T...T
T......T...T...T...T...T...T...T...T...T...T...T...T
T......T...T...T...T...T...T...T...T...T...T...T...T
T......T...T...T...T...T...T...T...T...T...T...TTTTT
T......T...T...T...T...T...T...T...T...T...T...T...T
T......T...T...T...T...T...T...T...T...T...T...T...T
T......T...T...T...T...T...T...T...T...T...T...T...T
T......T...T...T...T...T...T...T...T...T...T...T...T
T......T...T...T...T...T...T...T...T...T...T...T...T
T......T...T...T...T...T...T...T...T...T...T...T...T
T......T...T...T...T...T...T...T...T...T...T...T...T
T......T...T...T...T...T...T...T...T...T...T...T...T
T......T...T...T...T...T...T...T...T...T...T...T...T
T......T...T...T...T...T...T...T...T...T...T...T...T
T......T...T...T...T...T...T...T...T...T...T...T...T
T......T...T...T...T...T...T...T...T...T...T...T...T
T......T...T...T...T...T...T...T...T...T...T...T...T
T......T...T...T...T...T...T...T...T...T...T...T...T
T......T...T...T...T...T...T...T...T...T...T...T...T
T......T...T...T...T...T...T...T...T...T...T...T...T
T......T...T...T...T...T...T...T...T...T...T...T...T
T......T...T...T...T...T...T...T...T...T...T...T...T
T......T...T...T...T...T...T...T...T...T...T...T...T
T......T...T...T...T...T...T...T...T...T...T...T...T
T......T...T...T...T...T...T...T...T...T...T...T...T
T......T...T...T.......T...T...T.......T...T...T...T
T......T...T...T.......T...T...T.......T...T...T...T
T......T...T...T.......T...T...T.......T...T...T...T
T......T...T...TTTTTTTTT...T...TTTTTTTTT...T...T...T
T..........T...............T...............T.......T
T..........T...............T...............T.......T
T..........T...............T...............T.......T
TTTTTTTTTTTTTTTTTTTTTTTTTTTTTTTTTTTTTTTTTTTTTTTTTTTT